###########
#S..2...I.#
#.###.##..#
#...#...#.#
#.I.#.3...#
#...###.#.#
#..I....#.#
###########
